{
  "sli": 5,
  "PP": 7,
  "FF": 7,
  "TH": 6,
  "DD": 6,
  "kk": 17,
  "CH": 7,
  "SS": 6,
  "nn": 6,
  "RR": 7,
  "aa": 7,
  "E": 6,
  "ih": 6,
  "oh": 7,
  "ou": 7
}